0000000000
0111111110
0022222200
0003333000
0000000000
0111111110
0111111110
0333003330
0222222220
0000000000